00000000000
00000000000
00000000000
00011111000
00000000000
00111111100
00000000000
00110001100
00000000000
00222222200
00000000000
00022222000